Maze 1 - 7 8
########
#      #
###### #
#LL    #
#L######
#LLLP  #
######D#

